21000000000000000000
01000000000000040000
01000005005000000000
01000000000000000000
01000000000000000000
01000000000000000000
01000007560000000000
01000000000000000000
01000000000000000000
01000000000000000000
01000000000000000000
01000500000000000000
01000000000000000000
01000000000000000000
01000000005000000000
01000000000000000000
01000000000000000000
01000000000050000000
01000000000070000000
01111111111111111113